BBBBBBBBBBBBBBBBBBBBBBBBBBBBBBBBBBBBBBBBBBBBBBBBBBBBBBBBBBBBBBBBBBBBBBBBBBBBBBBBBBBBBBBBBBBBBBBBBBBBBBBBBBBBBBBBBBBBBBBBBBBBBBBBBBBBBBBBBBBBBBBBBBBBBBBBBBBBBBBBBBBBBBBBBBBBBBBBBBBBBBBBBBBBBBBBBBBB
BB           BBBBBBBB                 BBB                          BBBBBBBBB            BBBBBBBBBBBBBBBBBBBBBBBBBBBBBBBBBBBBB             BBBBBBB              BBBBBBBBBBBBBBBBBB      BBBBBBBBBBBBB
B             BBBBB                 BBBBBB                          BBBBBBB              BBBBBBBBBBBBB          BBBBBBBBBBBB               BBBBB               BBBBBBBBBBBBBBBBB        BBBBBBBBBBBB
BB             BBB                 BBBBBBBB                         BBBBBB               BBBBBBBBBBBB           BBBBBBBBB                   BBB                BBBBBBBBBBBBBBBB          BBBBBBBBBBB
BBB             B                 BBBBBBBBBB                        BBBBB                BBBBBBBBBBB            BBBBBBBBB                   BBB                BBBBBBBBBBBBBBB            BBBBBBBBBB
BBBB            B                 BBBBBBBBBBB                        BBB                 BBBBBBBBBB              BBBBBBB                    BBB               BBBBBBBBBBBBBBB             BBBBBBBBBB
BBBBB           B                 BBBBBBBBBBBB                       BBB                 BBBBBBBBB               BBBBBB                    BBBBB             BBBBBBBBBBBBBBB              BBBBBBBBBB
BBBBBB          BB                BBBBBBBBBBBBB                     BBBB                 BBBBBBBB                 BBBB                    BBBBBBB           BBBBBBBBBBBBBBB               BBBBBBBBBB
BBBBB            B                 BBBBBBBBBBB                    BBBBBB                BBBBBBBB                   BB                    BBBBBBBBB         BBBBBBBBBBBBBBBB              BBBBBBBBBBB
BBBB            B                                                                                                                            BB                                             BBBBBBBB
BBB                                                                                                                                          BB                                               BBBBBB
BB                                                                                                                                           BB                                                BBBBB
B                                                                                                                                            BB                                                 BBBB
B                                                                                                                                                                                                BBB
B                                                                                                                                                                                                 BB
BB                                                                                                                                                                                                 B
BBB                                                                                                                                                                                               BB
BBBB                                                                                                                                         BB                                                   BB
BBB                                                                                                                                          BB                                                  BBB
BB                                                                                                                                           BB                                                   BB
B                                                                                                                                            BB                                                 BBBB
BB                                                                                                                                           BB                                                  BBB
BBB                                                                                                                                          BB                                                   BB
BBBB                                                                                                                                         BB                                                  BBB
BBBB                                                                                                                                         BB                                                  BBB
BBB                                                                                                                                          BB                                                   BB
BB                                                                                                                                                                                               BBB
BBB                                                                                                                                                                                             BBBB
BBBB                                                                                                                                                                                           BBBBB
BBBBB                                                                                                                                                                                           BBBB
BBBBBB                                                                                                                                       BBBBBB                                              BBB
BBBBBBB                                                                                                                                      BBBBBBBBBBB          BBBBBBBBBBBBBBBBBBBBBBBBBBBBBBBBBB
BBBBBB                                                                                                                                                               BB                          BBB
BBBBBB                                                                                                                                                               BB                           BB
BBBBB                                                                                                                                                                BB                         BBBB
BBBBB                                                                                                                                                                BB                           BB
BBBBB                                                                                                                                                                                            BBB
BBBB                                                                                                                                                                                            BBBB
BBB                                                                                                                                                                                               BB
BBB                                                                                                                                                                                              BBB
BBB                                                                                                                                                                  BBBBB                       BBB
BBBB                                                                                                                                                                    BB                        BB
BBBBB                                                                                                                                                                   BB                       BBB
BBBBBB                                                                                                                                                                  BB                        BB
BBBBBBB                                                                                                                                                                 BB                      BBBB
BBBBBBBB                                                                                                                                                               BBB                     BBBBB
BBBBBBBBB                                                                                                                                                               BB                      BBBB
BBBBBBB                                                                                                                                                                 BBBB                     BBB
BBBBB                                                                                                                                                                     BBBB                  BBBB
BBB                                                                                                                                                                         BBBB                 BBB
BB                                                                                                                                                                         BBB                    BB
BBB                                                                                                                                                                         BB                   BBB
BBBB                                                                                                                                                                         B                    BB
BBBBB                                                                                                                                                                       BB                  BBBB
BBBB                                                                                                                                                                       BBB                   BBB
BBB                                                                                                                                                                       BBB                     BB
BBB                                                                                                                                                                     BBB                      BBB
BB                                                                                                                                                                    BBB                         BB
BBB                                                                                                                                                                    BB                        BBB
BBBB                                                                                                                                                                  BBB                         BB
BBBBB                                                                                                                                                                BBB                        BBBB
BBBBBBB                                                                                                                                                             BBB                          BBB
BBBBBBBBBB                                                                                                                                                           BBB                          BB
BBBBBBBBBBBB                                                                                                                                                        BBB                          BBB
BBBBBBBBBBBBB                                                                                                                                                        BBB                          BB
BBBBBBBBBBB                                                                                                                                                         BBB                          BBB
BBBBBBBBB                                                                                                                                                            BBB                        BBBB
BBBBBBBB                                                                                                                                                             BBB                      BBBBBB
BBBBBBB                                                                                                                                                               BBB                  BBBBBBBBB
B                                                                                                                                                                                                  B
B                                                                                                                                                                                                  B
B                                                                                                                                                                                                  B
B                                                                                                                                                                                                  B
B                                                                                                                                                                                                  B
B                                                                                                                                                                                                  B
B                                                                                                                                                                                                  B
B                                                                                                                                                                                                  B
B                                                                                                                                                                                                  B
B                                                                                                                                                                                                  B
B                                                                                                                                                                                                  B
B                                                                                                                                                                                                  B
B                                                                                                                                                                                                  B
B                                                                                                                                                                                                  B
B                                                                                                                                                                                                  B
B                                                                                                                                                                                                  B
B                                                                                                                                                                                                  B
B                                                                                                                                                                                                  B
B                                                                                                                                                                                                  B
B                                                                                                                                                                                                  B
B                                                                                                                                                                                                  B
B                                                                                                                                                                                                  B
B                                                                                                                                                                                                  B
B                                                                                                                                                                                                  B
B                                                                                                                                                                                                  B
B                                                                                                                                                                                                  B
B                                                                                                                                                                                                  B
B                                                                                                                                                                                                  B
B                                                                                                                                                                                                  B
B                                                                                                                                                                                                  B
B                                                                                                                                                                                                  B
B                                                                                                                                                                                                  B
B                                                                                                                                                                                                  B
B                                                                                                                                                                                                  B
B                                                                                                                                                                                                  B
B                                                                                                                                                                                                  B
B                                                                                                                                                                                                  B
B                                                                                                                                                                                                  B
B                                                                                                                                                                                                  B
B                                                                                                                                                                                                  B
B                                                                                                                                                                                                  B
B                                                                                                                                                                                                  B
B                                                                                                                                                                                                  B
B                                                                                                                                                                                                  B
B                                                                                                                                                                                                  B
BBBBBBBBBBBBBBBBBBBBBBBBBBBBBBBBBBBBBBBBBBBBBBBBBBBBBBBBBBBBBBBBBBBBBBBBBBBBBBBBBBBBBBBBBBBBBBBBBBBBBBBBBBBBBBBBBBBBBBBBBBBBBBBBBBBBBBBBBBBBBBBBBBBBBBBBBBBBBBBBBBBBBBBBBBBBBBBBBBBBBBBBBBBBBBBBBBBB

