BBBBBBBBBBBBBBBBBBBBBBBBBBBBBBBBBBBBBBBBBBBBBBBBBBBBBBBBBBBBBBBBBBBBBBBBBBBBBBBBBBBBB
BBB    BBBBBBBBBBBBBBBBBBBBBB   BB                   B BB B                        BB
BBB  B  BBB  BBB  BBBBBBBBBB  BB                      BBBB                         BB
BB B                  BBBBBBBB      g                 BBBBB                        BB
BB                     BBBBBBB                        BB                           BB
B                       BBBBBB               BBB    BBBBBBBB                B      BB
B         0              BBBB   B         BBB BB     BBBBBBB                       BB
B  BBB                   BBBB       BB  BB            BBBB         B               BB
B   BBB                   BBBB   B   BBB               BBB                         BB
B    BB                   BBBBB      B                BBB      3         B    2    BB
B    B           BB        BBBB  B B                   BBB                         BB
B                BB        BBB                BB        BB                         BB
B         a       BB       BBBB   B          BB        BBB                         BB
B BBB              B       BBBB             BB          BBB           b      B     BB
B   BB             BB      BBBBB           BB         BBBBB     B                  BB
B                   BB     BBBB           BB          BBB                          BB
B                          BBB           BB            BBBB           B            BB
B         1                BBB          BB                                         BB
B    BB             BB     BBB           BB                                        BB
B    BB             BB     BBBB          BB                                        BB
B    BB            BB      BBB            BB                                       BB
B    BB             BB     BBB           BBB          BBBBBB                       BB
BB   BB              BB    BBBB         BBBBB         BBBBBB                       BB
BB    BB              B    BBBB            BB         BBBBBB                       BB
B     BB                   BBBB            BB        BBBBBBBB                      BB
BB                         BBBB            BB        BBBBBBBB                      BB
BB                         BBB            BB           BBBB                        BB
BB                         BB            BB              BB                        BB
BB                         BB            BB             BB                         BB
BBB                       BBBBB          BB     f      BBBB                        BB
BBBBBB                    BBBB            BB          BBB                BB        BB
BBBBBB        BB         BBBBB            BB            BBBBB           BBBB       BB
BBBBBBB        BB    BBBBBBBBB             BB        BBBBB               BBB       BB
BBBBBB         BB         B BBB           BBB         BBBBB               BBB      BB
BBBBBB         BB            BBB           BB           BBBB               BB      BB
BBBBB         BBB         BBB BB           BB         BBB                 BBB      BB
BBBB         BBB           BB BB         BBB            BBB                BB      BB
BBB         BB             BBB BB          BB        BBBBBBBBB         f           BB
BBBB       BBB                            BBB        BBBBBBB                       BB
BBB                                      BBB          BBBBB                        BB
BBB                                                    BBBBBB                      BB
BBBB                  BB                BBB          BBBBBB                        BB
BBBBB               BBBBBB        BBBB BB               BB            B           BBB
BBBBBB          B  BB   BBBB   BBB   BBB              BBBBB          BB           BBB
BBBBBBB       BB          BBBBBB                        BBB         BBBBB       BBBBB
BBBBBB         BB BB                                   BBBBB         BBBB      BBBBBB
BB  BB        BBBBB                                    BBB          BBBBB      BBBBBB
BBBBB           BBBB                                    BBBB        BBBBB      BBBBBB
B BBBB        BBBBB                                      BBB         BBB       BBBBBB
B   BBB       BBBB                                     BB BBB         B         BBBBB
B     BB                                                   BB                   BBBBB
B     BB                                                B BBB                    BBBB
B    BB                       BBB                        B BB                     BBB
B f  B               BBB   BBB BBBBB                   BBBBBBBB                   BBB
B    BB             BBBBBBBB      BBBB                                            BBB
B    BB           BB                 BBBB                            BBBB         BBB
B     BB                               BBB                             BB         BBB
B      BBB       BB                     BBB                            BBB        BBB
B     BBB       BB                       BBB                            BB        BBB
B      BBB                                BBB         BBBBB              BB       BBB
B        BB                                BBB          BBBB             BB      BBBB
B                                    g      BBB   f    BBBBB            BBB      BBBB
B                                            BB       B BBB                       BBB
B                                           BBB         BBB                       BBB
B                                                      BBBB                       BBB
B                                                     B BBB         g            BBBB
B                                                       BBB                     BBBBB
B                                                     BBBBBBB                  BBBBBB
BBBBBBBBBBBBBBBBBBBBBBBBBBBBBBBBBBBBBBBBBBBBBBBBBBBBBBBBBBBBBBBBBBBBBBBBBBBBBBBBBBBBB

